10 10
1 1 1 1 1 1 1 1 1 1
2 4 1 2 3 1 2 3 4 1
6 2 3 5 1 3 2 5 4 1
3 1 4 5 6 7 1 3 4 2
1 1 0 0 0 0 0 0 1 1
1 1 0 0 0 0 0 0 1 1
1 7 1 1 5 1 6 1 1 1
2 4 1 2 3 1 2 1 4 1
6 2 1 1 1 3 2 5 4 1
1 2 3 1 2 3 6 3 7 1